flat file document parser - parses flat text files.
time generator - generates time values time to string - converts a timestamp column into a column  holding strings.
- incidence matrix - creates the incidence matrix.
id3 - class for constructing an unpruned decision tree based on  the id3 algorithm.
multischeme - class for selecting a classifier from among  several using cross validation on the training data or the performance on the  training data.
table edge table - writes the id and label of all edges and their  incident nodes of the incoming network to a data table.
- xml row combiner - concatenates the cells in a xml column.
- optics - mihael ankerst, markus m. breunig, hans-peter kriegel, joerg sander: optics:
visualization network viewer - visualizes a network.
- color appender - assigns an existing color model to a table.
punctuation erasure - erases the punctuation characters of terms.
- libsvmpredictor - takes a trained libsvm to predict the values for new data.
- distance matrix - distance matrix reader - reads triangular or full distance matrix.
classificationviaregression - class for doing classification  using regression methods.
a density-based algorithm for discovering clusters in large spatial  databases with noise.
it uses two variables for the position of a data point and a third one is mapped to the radius of the point.
rgb merge - merges three gray value images into a color image.
subgraph extractor - extracts sub graphs from the given network.
this value is gaussian distributed as defined in the  configuration by its mean and standard deviation.
- model loop end - collects and combines all models provided during the loop iterations.
weblog reader - this node reads apache log files.
- winnow - implements winnow and balanced winnow algorithms by littlestone.
ng predictor (beta) - predictor node for neighborgram  classification model.
- moving average - adds a column with moving average values.
this node allows to group numeric data in intervals - called bins.
- ng visual clusterer (beta) -
case converter - converts terms to lower or upper case.
r predictor (local) - allows to import a r model and predict  given data by the use of the model.
- rgb merge - merges three gray value images into a color image.
- hnb - contructs hidden naive bayes classification model with high classification accuracy and auc.
j48 - class for generating an alternating decision tree.
parallel chunk start - represents the start of a parallel  chunked flow.
mining network analyzer - analyzes the network.
- jrip - this class implements a propositional rule learner, repeated incremental pruning to produce error reduction (ripper).
disturber node - takes the input table, and creates three  different output tables from it.
(more efficient version of  stacking).
- variable based file reader - ascii file reader from variable locations - variable to tablecolumn - appends one or more variables as new column(s) to the data table.
- csv reader - reads csv files.
- extract variables (database) - extracts variables from a database connection.
- arff writer - writes data into a file in arff format.
regex filter - filters all terms matching the specified regular  expression.
- weka predictor - the weka predictor takes a model generated in a weka node and classifies the test data at the inport.
- complementnaivebayes - class for building and using a complement class naive bayes classifier.
feature list filter - this filter either bypasses or filters the  network elements (nodes/edges) which features match the values of the given  data table.
- model loop start - provides one model from the input table at a time to the output.
- bftree - class for building a best-first decision tree classifier.
- pie chart (jfreechart) - node to display a pie chart.
- multischeme - class for selecting a classifier from among several using cross validation on the training data or the performance on the training data.
- oscar tagger - assigns chemical named entity tags to terms.
- decision tree - decision tree learner - decision tree induction performed in memory.
- ensemble learning - utility nodes - boosting learner loop end - loop end node for learning an ensemble model with boosting - boosting learner loop start - loop start node for learning an ensemble model with boosting - boosting predictor loop end - loop end node for predicting a boosted ensemble model - boosting predictor loop start - loop start node for predicting a boosted ensemble model - cell to model - converts a single table cell into a model output.
additiveregression - meta classifier that enhances the  performance of a regression base classifier.
- table creator - allows the manual creation of a data table with any number of rows and columns.
- tablerow to variable - defines new flow variables based on a single row of the input table and exposes them using a variable connection.
- datanearbalancednd - a meta classifier for handling multi-class datasets with 2-class classifiers by building a random data-balanced tree structure.
misc empty table creator - creates an empty table: simply lines and  rowkeys (no columns).
- variables loop (data) - variables loop (database) - x-validation - provides a skeleton of nodes necessary for cross validation - flow control - loop support - counting loop start - node at the start of a loop - chunk loop start - chunking loop start, each iteration processes different chunk of rows.
one row to many - creates duplicates of the rows, based on an  integer column.
- model reader - reads knime model port objects from a file.
lazy ib1 - nearest-neighbour classifier.
- document viewer - displays all data of the given documents, like text, authors, publication date and so on.
- row splitter - allows splitting of the input table by certain criteria, such as row id, attribute value, and row number range.
gaussian distributed assigner - assigns a value based on the  class column.
- string manipulation - allows to do string manipulations like search and replace, capitalize or remove leading and trailing white spaces.
you can use the groupby-node to gain the required columns.
- windows - 64bit (regularly tested on vista and verified to work under windows 7) - linux - 32bit (regularly tested on rhel4/5, opensuse 10.2/10.3/11.0, amongst others) - linux - 64bit (regularly tested on rhel4/5, opensuse 10.2/10.3/11.0, amongst others) - mac osx - 64bit intel-based architecture with java 1.6 list of available nodes (modules) - io - read - file reader - flexible reader for ascii files.
- value counter - counts the occurrences of values in a column - mining - bayes - naive bayes learner - creates a naive bayes model from the given classified data.
- replacer - replaces pattern in terms matching the specified regular expression with the defined replacement.
- disturber node - takes the input table, and creates three different output tables from it.
network reader - reads a network from a file.
ppilot connector - accesses pipeline pilot web services.
feature filter - hides features from the input network.
random label assigner - assigns the labels based on the  probabilities to the rows.
the result of these r commands is returned in the output table of this  node.
- many2one - aggregates several columns into one single column.
- interval chart (jfreechart) - displays a interval chart.
suitable for german and english texts.
- bayesnet - bayes network learning using various search algorithms and quality measures.
- extract variables (data) - extracts variables from a data connection.
keygraph keyword extractor - extracts relevant keywords from  documents.
- difference checker - compares the two input tables.
- strings to document - converts the specified strings to documents.
the database is simply handed through.
complementnaivebayes - class for building and using a complement  class naive bayes classifier.
- external tool (labs) - process the input data using an external application.
a new column is appended with the result of the comparison.
- splitter - splits the columns of the input table into two output tables.
grading - implements grading.
file upload - quick form node that allows uploading a file and  exposing that uploaded file using a flow variable.
stop word filter - filters terms contained in the stop word file.
association rules apriori - class implementing an apriori-type algorithm.
- pmml predictor - can predict the data using the pmml object.
if - merges two branches which were initially created by an if switch node.
- opennlp ne tagger - assigs named entity tags, such as "person" or "location".
- snowball stemmer - stems terms with the snowball stemmer.
term vector - creates a term vector for each term.
this method constructs a decision tree based  classifier that maintains highest accuracy on training data and improves on  generalization accuracy as it grows in complexity.
- naivebayesmultinomial - class for building and using a multinomial naive bayes classifier.
this value is gamma distributed.
- node degree filter - filters all nodes by their degree e.g. number of incoming/outgoing edges.
text processing dml document parser - parses dml formatted documents.
tag cloud - creates a tag cloud meta vector creation web analytics byte converter - this node allows the values of a column to be  converted between byte, kilobyte, megabyte, gigabyte and terabyte.
oscar filter - filters terms with certain chemical named entity  tags.
- network writer - writes the given network to a file.
ordering points to identify the clustering structure.
- randomcommittee - class for building an ensemble of randomizable base classifiers.
- other - add empty rows - adds a certain number of empty rows with missing values or a given constant to the input table.
- r to pmml (local) - converts a given r object into a corresponding pmml object.
- term to structure - converts terms to molecule structures represented as strings and adds a new column containing them.
standard named entity filter - filters terms with standard named  entity tags not specified in the dialog.
ng learner (beta) - learns a classification model based on  neighborgrams.
- database writer - establishes and opens a database access connection to which the entire input table is written to. be written.
- database query - modifies the input sql query from a incoming database connection.
- object inserter - inserts nodes and edges from a data table into the network.
reptree - fast decision tree learner.
term to string - converts terms to strings and adds a new column  containing these strings.
- testing - block programmatically - uses a lock to hold the execution until a prgrammatic "release" is triggered.
- io - r model reader - reads an r model from a file.
trees adtree - class for generating an alternating decision tree.
- n chars filter - filters terms consisting of less than n characters.
- pubmed document parser - parses pubmed search results documents.
- functions - gaussianprocesses - implements gaussian processes for regression without hyperparameter-tuning.
- k-means - creates a crisp center based clustering.
- lazy - ib1 - nearest-neighbour classifier.
node name filter - filters all nodes by their label.
- predictors - weka cluster assigner - the weka cluster assigner takes a cluster model generated in a weka node and assigns the data at the inport to the corresponding clusters.
- inject variables (database) - merges variables from one connection into the database connection.
- category to number (apply) - maps each category of a column with nominal data to an integer.
- pmml reader - reads models from a pmml compliant xml file.
- generalizedsequentialpatterns - class implementing a gsp algorithm for discovering sequential patterns in a sequential data set.
implements base routines for generating m5 model trees and rules.
smoreg - implements alex smola and bernhard scholkopf's  sequential minimal optimization algorithm for training a support vector  regression model.
node neighbor extractor - extracts all neighbors of the given  node ids.
icf - computes the inverse category frequency (icf) of each term  according to the given set of documents, categories of documents respectively,  and adds a column containing the icf value.
xml row combiner - concatenates the cells in a xml column.
- word parser - parses word (.doc) files.
model content difference checker - compares the two input models.
used in workflow manager unit tests.
- simplelinearregression - learns a simple linear regression model.
optics - mihael ankerst, markus m. breunig, hans-peter kriegel,  joerg sander: optics:
testing block programmatically - uses a lock to hold the execution until  a prgrammatic "release" is triggered.
- fuzzy rule predictor - applies a fuzzy rule model to numeric data and outputs a prediction for each test instance.
- row - filter - hilite filter - partitions input rows based on their current hilite status.
creates a node, edge and feature table.
edge weight filter - filters all edges by their weight.
document data extractor - extracts data from a document into  data columns document vector - creates a document vector for each document.
- string matcher - the node finds for each string in the data list the most similar words of the dictionary list.
chemistry extensions - partner extension compatibility - product documentation - features - knime report designer - overview - features - applications - examples - installation - newsletter - knime press - knime beginner's luck - the knime cookbook - the knime booklet for sas© users - demos & tours - screenshots - knime merchandise - company - overview - knime open source story & license - news - events - team - careers - contact us - travel information you are here: / home / resources / product documentation / features resources - overview - download / update - product documentation - features - knime report designer - installation - newsletter - knime press - demos & tours - screenshots - knime merchandise forum & documentation features one key behind the success of knime is its inherent modular workflow approach, which documents and stores the analysis process in the order it was conceived and implemented, while ensuring that intermediate results are always available.
- write - csv writer - saves a datatable into an ascii file.
- data to report - provides the incoming data to the knime report designer.
- jpython script 2:1 - executes a jpython script, taking 2 input tables and returning 1 output table.
- mask date/time - masks (removes) date or time fields from existing date/time.
zernike reconstructor - reconstructs an image based on zernike  features.
- regressionbydiscretization - a regression scheme that employs any classifier on a copy of the data that has the class attribute (equal-width) discretized.
- tag cloud - creates a tag cloud - meta - extended ner preprocessing - frequencies - simple preprocessing - vector creation - web analytics - byte converter - this node allows the values of a column to be converted between byte, kilobyte, megabyte, gigabyte and terabyte.
datanearbalancednd - a meta classifier for handling multi-class  datasets with 2-class classifiers by building a random data-balanced tree  structure.
generalizedsequentialpatterns - class implementing a gsp  algorithm for discovering sequential patterns in a sequential data set.
node adjacency matrix - creates the node adjacency matrix.
- network reader - reads a network from a file.
- logitboost - class for performing additive logistic regression.
- viz input connector - read networks from external program.
- r snippet (local) - allows execution of r commands in a local r installation.
- meta - cross validation - x-partitioner - data partitioner for use in a cross-validation flow - x-aggregator - node that aggregates the result for cross validation.
- attributeselectedclassifier - dimensionality of training and test data is reduced by attribute selection before being passed on to a classifier.
incidence matrix - creates the incidence matrix.
- hierarchical cluster assigner - assigns clusters to rows based on an hierarchical clustering.
- standard named entity filter - filters terms with standard named entity tags not specified in the dialog.
- multiboostab - class for boosting a classifier using the multiboosting method.
r model writer - writes an r model to a (zip) file.
- oscar filter - filters terms with certain chemical named entity tags.
- column rename - enables you to rename column names or to change their types.
- porter stemmer - stems terms the porter way.
- em - simple em (expectation maximisation) class.
term to structure - converts terms to molecule structures  represented as strings and adds a new column containing them.
picture chooser - reads images from a directory.
- cell to pmml - converts the pmml cell in the first row to the pmml port.
java if switch on tables - empty table replacer - replaces an empty table with an inactive branch.
assign partition - assigns objects to the given partition of the  given type.
- double to int - converts double in a column to integers.
string input - outputs a string flow variable with a given value.
- feature value filter - this filter either bypasses or filters the network elements (nodes/edges) that match the given filter value.
waode - waode contructs the model called weightily averaged  one-dependence estimators.
- sota learner - clusters numerical data with sota.
table to pdf - generates pdf reports out of input data by using  the birt reporting engine.
network writer - writes the given network to a file.
misc category to class - adds a class (string) column to each row,  containing the category string of the document in that particular row.
- parallel chunk end (multi port) - represents the end of a parallel chunked flow.
porter stemmer - stems terms the porter way.
string matcher - the node finds for each string in the data list  the most similar words of the dictionary list.
- testflow configuration - configures a workflow test - weka - classification algorithms - bayes - aode - aode achieves highly accurate classification by averaging over all of a small space of alternative naive-bayes-like models.
- voronoi segmentation - voronoi based segmentation - features - histogram node - calculates the histogram features of an image.
- naivebayesupdateable - class for a naive bayes classifier using estimator classes.
- xml combine and write - writes xml cells in a file.
- string to term - converts strings to terms.
zeror - class for building and using a 0-r classifier.
- plsclassifier - a wrapper classifier for the plsfilter, utilizing the plsfilter's ability to perform predictions.
- random label assigner (data) - assigns the labels based on the probabilities to the rows.
- bubble chart (jfreechart) -
- molfile reader - reads molecules from a directory with molfiles - molfile writer - writes molecules as molfiles to a directory
- line node - calculates the line features of an image.
segmentation binary image segmentation - segments an image based on a binary  signal image.
- database row filter - the database row filter allows to filter rows from database table.
- reporting - table writer - table to html - generates html reports out of input data by using the birt reporting engine.
- rules - conjunctiverule -
smo - implements john platt's sequential minimal optimization  algorithm for training a support vector classifier.
- one2many - transforms the values of one column into appended columns.
- list files - creates a list with the locations and urls of the files contained in a given folder.
shortest path - finds the shortest paths between two defined  objects.
xml column combiner - merges xml columns in a single column.
- scatter plot (jfreechart) -
can be  used to convert a directed into an undirected network by filtering the  is_target feature.
linearregression - class for using linear regression for  prediction.
chi-square keyword extractor - extracts relevant keywords from  documents.
weka classifier writer - writes a weka classification model to a  (zip) file.
- prism - class for building and using a prism rule set for classification.
- groupby bar chart (jfreechart) - displays a bar chart for all ready grouped columns with nominal values.
- punctuation erasure - erases the punctuation characters of terms.
- r view (local) - enables the usage of r views using the local r installation.
- smoreg - implements alex smola and bernhard scholkopf's sequential minimal optimization algorithm for training a support vector regression model.
- document grabber - downloads and parsers documents.
- utility - image to table - converts a given image into a table with one cell.
- column resorter - resorts the order of the columns based on user input - denormalizer - denormalizes the attributes of a table according to a model.
- subgraph extractor - extracts sub graphs from the given network.
- ng predictor (beta) - predictor node for neighborgram classification model.
- string input - outputs a string flow variable with a given value.
metacost - this metaclassifier makes its base classifier  cost-sensitive.
- bagging - class for bagging a classifier to reduce variance.
- viz output connector - send networks to external program.
- column combiner - combines the content of a set of columns and appends the concatenated string as separate column to the input table.
- java snippet row filter - java snippet based row filter - java snippet row splitter - java snippet based row splitter - create temp dir - creates a temporary directory upon execute and exposes its path as flow variable.
the loop end node for performing delegating, a version of meta learning.
the base classifiers are "graded".
- lmt - classifier for building 'logistic model trees', which are classification trees with logistic regression functions at the leaves.
- waode - waode contructs the model called weightily averaged one-dependence estimators.
- missing value - filters or replaces missing values in a table.
r to pmml (local) - converts a given r object into a  corresponding pmml object.
main menu search: - products - overview - knime desktop - knime professional - knime team space - knime server - knime cluster execution - extensions - applications - overview - churn analysis - credit scoring - chemical library enumeration - social media music recommendation - virtual high throughput screening - example workflows - partners - becoming a partner - channel partners - consulting partners - development partners - sponsors - services - overview - trainings - certified coaches - resources - overview - download / update - download - update site - previous versions - data sets - free marvin
- bagging - bagging - boosting learner - boosting learner - boosting predictor - boosting predictor - delegating - delegating - item sets / association rules - association rule learner - searches for frequent itemsets with a certain minimum support in a set of transactions and optionally generates association rules with a predefined confidence value from them.
bagging - class for bagging a classifier to reduce variance.
the node visualize the input data by putting each data point to the position on the plot (x and y value).
- lift chart - creates a lift chart - line plot - plots the numeric columns as lines.
- regex filter - filters all terms matching the specified regular expression.
- clustering - cluster assigner - assigns data to a set of prototypes.
- moss - searches for frequent fragments in a set of molecules.
- meta - feature elimination - backward feature elimination - iterate list of files -
iteratively executes the contained flow on a list of files.
- network feature extractor - creates for each network a feature vector.
- adaboostm1 - class for boosting a nominal class classifier using the adaboost m1 method.
- nbtree - class for generating a decision tree with naive bayes classifiers at the leaves.
m5rules - generates a decision list for regression problems
- random item inserter - assigns the labels based on the probabilities to the rows.
- database connector - creates a database connection to the specified database.
- feature list filter - this filter either bypasses or filters the network elements (nodes/edges) which features match the values of the given data table.
- sdf reader - reads molecules from an mdl sdf file - sdf writer - writes molecules to an mdl sdf file - smiles directory reader - reads molecules from a directory with smiles files - smiles directory writer - writes molecules as single files to a directory - mining - fingerprint bayesian (learner) - (variant) of naive bayes for fingerprint columns, i.e. bitvectors.
- part - class for generating a part decision list.
- meta - nesteddichtonomies - classbalancednd - a meta classifier for handling multi-class datasets with 2-class classifiers by building a random class-balanced tree structure.
- simplekmeans - cluster data using the k means algorithm.
stacking - combines several classifiers using the stacking  method.
- additiveregression - meta classifier that enhances the performance of a regression base classifier.
- decision tree predictor - uses an existing decision tree to compute class labels for input vectors.
- userclassifier - interactively classify through visual means.
- m5rules - generates a decision list for regression problems
randomforest - class for constructing a forest of random trees.
views picture hilite tableview - allows to hilite segments in an image.
normalizes the attributes of a table according to a model.
nbtree - class for generating a decision tree with naive bayes  classifiers at the leaves.
naivebayesupdateable - class for a naive bayes classifier using  estimator classes.
- kuhlen stemmer - stems terms with the kuhle stemming algorithm.
- stacking - combines several classifiers using the stacking method.
- views - picture hilite tableview - allows to hilite segments in an image.
- scatter plot - creates a scatterplot of two selected attributes.
- id3 - class for constructing an unpruned decision tree based on the id3 algorithm.
random matcher - assigns the information from the second table  randomly to the rows of the first table stresser - adds stress (outliers) to the values.
pdf parser - parses pdf files.
dictionary tagger - assigns specified tags values of specified  tag types to terms specified in an dictionary column.
xml xml reader - reads a xml file.
lmt - classifier for building 'logistic model trees', which are  classification trees with logistic regression functions at the leaves.
feature table - writes selected features of the incoming network  to a data table.
- delegating loop end -
- numerical - beta distributed assigner - assigns a value based on the class column.
tf - computes the relative term frequency (tf) of each term  according to each document and adds a column containing the tf value.
normalizes the attributes of a table according to a pmml model.
- filteredcluster - class for running an arbitrary clusterer on data that has been passed through an arbitrary filter.
- chi-square keyword extractor - extracts relevant keywords from documents.
- shortest path - finds the shortest paths between two defined objects.
- weka serializedclassifier read - a wrapper around a serialized classifier model.
- xls reader - reads a data table from a spread sheet.
- size manager - assigns sizes corresponding to the values of one numeric column.
- histogram (interactive) - displays data in an interactive histogram view with hiliting support.
different combinations  of probability estimates for classification are available.
- fuzzy c-means - performs fuzzy c-means clustering.
timedelay loop end -
r view (remote) - enables the usage of r views generated on an r  server.
this node converts alphanumeric characters to lowercase or uppercase.
- universe marker (apply) - applies universe definition as given from universe marker node.
object id filter - filters all objects e.g. edges and nodes by  their id. partition filter - this node filters all objects (nodes and/or  edges) that are member of the selected partition(s).
- file difference checker - compares the two files.
feature inserter - inserts features from a data table into the  network.
- r view (remote) - enables the usage of r views generated on an r server.
- pmml - denormalizer - denormalizes the attributes of a table reversing the information in the pmml model.
- end (model) case - merges two or more branches with arbitrary models which were initially created by an if or case switch node.
- dictionary tagger - assigns specified tags values of specified tag types to terms specified in an dictionary column.
neighbor filter - filters all objects pairs from the input table  that are not adjacent/incident in the network.
- node name filter - filters all nodes by their label.
- zernike reconstructor - reconstructs an image based on zernike features.
- pmml writer - reads a model from a pmml port and writes it into a pmml v3.1 compliant file.
node table - writes all nodes of the incoming network to a data  table.
pubmed document parser - parses pubmed search results documents.
remote r snippet (remote) - allows execution of r commands on an r  server.
- threshold - thresholds the input images locally with otsu thresholding.
- fail in execution - node that always fails upon execution.
- binner (dictionary) - categorizes values in a column according to a dictionary table with min/max values.
- object id filter - filters all objects e.g. edges and nodes by their id. - partition filter - this node filters all objects (nodes and/or edges) that are member of the selected partition(s).
- string radio buttons - outputs a string flow variable with a given value.
- timedelay loop end -
- zernike node - calculates the zernike features of an image.
predictors weka cluster assigner - the weka cluster assigner takes a  cluster model generated in a weka node and assigns the data at the inport to  the corresponding clusters.
- data manipulation - column - binning - auto-binner -
- table to pdf - generates pdf reports out of input data by using the birt reporting engine.
different combinations of probability estimates for classification are available.
- mining - network analyzer - analyzes the network.
sentence extractor - extracts all sentences of a document as  string.
testflow configuration - configures a workflow test weka classification algorithms bayes aode - aode achieves highly accurate classification by averaging  over all of a small space of alternative naive-bayes-like models.
part - class for generating a part decision list.
- ibk - k-nearest neighbours classifier.
xpath - performs a xpath query on a xml column.
- histogram - displays data in a histogram view.
- create collection column - combines multiple columns into a new collection column.
- cache - caches all input data (rows) onto disk for fast access.
- cell replacer - replaces cells in a column according to dictionary table (2nd input).
perl scripting - runs a perl script which creates a new column  or replaces an existing one.
- ppilot connector - accesses pipeline pilot web services.
convert edge adjacency matrix - creates the edge adjacency matrix.
threshold - thresholds the input images locally with otsu  thresholding.
rules conjunctiverule - this class implements a single conjunctive  rule learner that can predict for numeric and nominal class labels.
- interactive table - displays data in a table view.
- row sampling - extracts a sample (a bunch of rows) from the input data.
- weblog reader - this node reads apache log files.
- end case - merges 1-3 branches which were initially created by an if or case switch node.
- external tool - executes an external tool.
- pdf parser - parses pdf files.
simplecart - class implementing minimal cost-complexity pruning.
- numeric binner - group values of numeric columns categorized string type.
bayesnet - bayes network learning using various search  algorithms and quality measures.
svmreg - svmreg implements the support vector machine for  regression.
the discretization is performed with respect to a selected class column.
- scoring - enrichment plotter - draws enrichment curves - entropy scorer - scorer for clustering results given a reference clustering.
replacer - replaces pattern in terms matching the specified  regular expression with the defined replacement.
- misc - java snippet - java snippet - calculates a new column based on java code snippets.
- jfreechart - bar chart (jfreechart) - displays a bar chart for columns with nominal values.
- transform - case converter -
a density-based algorithm for discovering clusters in large spatial databases with noise.
parallel chunk end (multi port) - represents the end of a  parallel chunked flow.
- term vector - creates a term vector for each term.
- zeror - class for building and using a 0-r classifier.
- statistics - calculates statistic moments and counts nominal values and their occurrences across all columns.
jrip - this class implements a propositional rule learner,  repeated incremental pruning to produce error reduction (ripper).
meta nesteddichtonomies classbalancednd - a meta classifier for handling multi-class  datasets with 2-class classifiers by building a random class-balanced tree  structure.
naivebayes - class for a naive bayes classifier using estimator  classes.
- tertius - finds rules according to confirmation measure (tertius-type algorithm).
viz output connector - send networks to external program.
fail in execution - node that always fails upon execution.
- other - data generator - creates random data with clusters.
- naivebayes - class for a naive bayes classifier using estimator classes.
costsensitiveclassifier - a metaclassifier that makes its base  classifier cost-sensitive.
jpython script 2:1 - executes a jpython script, taking 2 input  tables and returning 1 output table.
racedincrementallogitboost - classifier for incremental learning  of large datasets by way of racing logit-boosted committees.
column to xml - create an xml column from input data.
start node for a backward feature elimination loop - backward feature elimination end - end node for a backward feature elimination loop - backward feature elimination filter - applies a feature filter model built during backward feature elimination - chemistry - i/o - mol2 reader - reads molecules from a mol2 file - mol2 writer - writes a mol2 column to a mol2 file.
- database connection writer - writes the input database table into a new database table.
pos filter - filters terms with certain pos tags.
- pivoting - pivots and groups the input table by the selected columns for pivoting and grouping; enhanced by column aggregations.
word parser - parses word (.doc) files.
- zernike converter - transforms complex numbers into normal double values using the magnitude.
this node implements the caim discretization algorithm according to kurgan and cios (2004).
- xml writer - writes xml documents in a directory.
lbr - lazy bayesian rules classifier.
partition table - creates a data table that contains the  partition names per object for the selected partition types.
decisionstump - class for building and using a decision stump.
document grabber - downloads and parsers documents.
- column to grid - breaks a selected column (or set of columns) into new columns, such that they align in a grid.
randomtree - class for constructing a tree that considers k  randomly chosen attributes at each node.
stackingc - implements stackingc
- parallel execution - parallel chunk end - represents the end of a parallel chunked flow.
- insert column header - updates column names of a table according to the mapping in second dictionary table.
core knime features include: - scalability through sophisticated data handling (intelligent automatic caching of data in the background while maximizing throughput performance) - high, simple extensibility via a well-defined api for plugin extensions - intuitive user interface - import/export of workflows (for exchanging with other knime users) - parallel execution on multi-core systems - command line version for "headless" batch executions available knime modules cover a vast range of functionality, such as: - i/o: retrieves data from files or data bases - data manipulation: pre-processes your input data with filtering, group-by, pivoting, binning, normalization, aggregation, joining, sampling, partitioning, etc. - views: visualize data and results through several interactive views, allowing for interactive data exploration - hiliting: ensures hilited data points in one view are also immediately hilited in all other views - mining: uses state-of-the-art data mining algorithms like clustering, rule induction, decision tree, association rules, naïve bayes, neural networks, support vector machines, etc. to better understand your data supported operating systems - windows - 32bit (regularly tested on xp and vista)
- mds - mds - multi dimensional scaling node, mapping data of a high dimensional space onto a lower dimensional space by applying the sammons mapping.
neighborgrams universe marker - defines universes (i.e. descriptors) for  processing in neighborgrams or fuzzy cu means.
xslt - applies xslt stylesheets on the cells of an xml column.
idf - computes the inverse document frequency (idf) of each term  according to the given set of documents and adds a column containing the idf  value.
- misc - sdf extractor - extracts the the various parts from sdf molecules into columns - sdf inserter - inserts properties to sdf/mol/ctab structures - translators - molecule type cast - converts a string column to typed molecule column - openbabel - converts various molecular file formats into each other - chemaxon / infocom - marvin - marvinsketch - marvinsketch is a chemical structures editor tool.
preset date/time - presets date or time to timestamps lacking  this information.
- keygraph keyword extractor - extracts relevant keywords from documents.
the final result tables' columns are named r1, r2, and so on.
random number assigner - assigns a value based on the class  column.
isotonicregression - learns an isotonic regression model.
simplelinearregression - learns a simple linear regression model.
- database column filter - the database column filter allows columns to be excluded from the input table database table.
- lwl - locally weighted learning.
- icf - computes the inverse category frequency (icf) of each term according to the given set of documents, categories of documents respectively, and adds a column containing the icf value.
- stop word filter - filters terms contained in the stop word file.
random label assigner (data) - assigns the labels based on the  probabilities to the rows.
- weka classifier reader - reads a weka classification model from a (zip) file.
- partition table - creates a data table that contains the partition names per object for the selected partition types.
variable output - provides the value of a selected variable to a  remote quick form.
- equal size sampling - removes rows from the input data set such that the values in a categorical column are equally distributed.
- logistic regression (predictor) - predicts the response using a general regression model.
- modifiable term filter - filters terms which are set modifiable or unmodifiable, respectively.
logistic - class for building and using a multinomial logistic  regression model with a ridge estimator.
olm - this class is an implementation of the ordinal learning  method.
this value is beta distributed.
this value is uniformly distributed between given min. and max.
v5.0 - hyperpipes - class implementing a hyperpipe classifier.
- sorter - sorts the rows according to user-defined criteria.
- rule engine - applies user-defined business rules to the input table - matrix - transpose - transposes a table by swapping rows and columns.
- r - local - r learner (local) - allows execution of r commands in a local r installation and build a r model.
- misc - flr - fuzzy lattice reasoning classifier (flr)
- column rename (regex) - renames all columns based on regular expression search & replace pattern.
this metaclassifier makes its base classifier cost-sensitive.
- enrichment - abner tagger - assigns biomedical named entity tags to terms.
a metaclassifier that makes its base classifier cost-sensitive.
- pnn predictor - applies a pnn model to numeric data and outputs a classification.
- hierarchical cluster view - shows the results of hierarchical clustering.
r snippet (local) - allows execution of r commands in a local r  installation.
zernike node - calculates the zernike features of an image.
- time field extractor - extracts time fields such as and appends the value as integer columns.
- marvinspace - marvinspace is a 3d molecule visualization tool.
python jpython function - executes a jpython function jpython script 1:1 - executes a jpython script, taking 1 input  table and returning 1 output table.
- segmentation - binary image segmentation - segments an image based on a binary signal image.
attributeselectedclassifier - dimensionality of training and  test data is reduced by attribute selection before being passed on to a  classifier.
- votedperceptron - implementation of the voted perceptron algorithm by freund and schapire.
- rowid - node to replace the rowid and/or to create a column with the values of the current rowid.
string to date/time - parses date and/or time strings into  date/time cells.
integer input - outputs an integer flow variable with a given  value.
- polynomial regression (learner) - learner that builds a polynomial regression model from the input data - regression (predictor) - predicts the response using a regression model.
- multiclassclassifier - a metaclassifier for handling multi-class datasets with 2-class classifiers.
- distance matrix calculate - calculates distance matrix on input table and appends result as (typed) column.
- tablerow to variable loop start - iterates over an input data table, whereby each row defines on iteration with variable settings taken from the values in that row - loop end - node at the end of a loop - variable condition loop end - loop end node that check for a condition in one of the flow variables - interval loop start - node at the start of a loop - loop end (2 ports) - node at the end of a loop - loop end (column append) - node at the end of a loop, collecting the intermediate results by joining the tables on their row ids.
the first output port contains the data that matches the criteria, the second the that does not comply with the settings.
- variable to tablerow - extracts variables and puts them into a single row table.
- low variance filter - filters out numeric columns, which have a low variance.
- j48 (weka) - generates an unpruned or pruned c4.5 decision tree (weka).
logitboost - class for performing additive logistic regression.
lwl - locally weighted learning.
- count execution programmatically - counts the number of executions.
- multilayerperceptron - a classifier that uses backpropagation to classify instances.
hiliting is not supported.
cvparameterselection - class for performing parameter selection  by cross-validation for any classifier.
- hierarchical clustering - performs hierarchical clustering.
densitybasedcluster - class for wrapping a clusterer to make it  return a distribution and density.
- rprop mlp learner - builds and learns an mlp with resilient backpropagation.
- joiner - joins two tables - regex split - splits an input string (column) into multiple groups according to a regular expression.
- feature table - writes selected features of the incoming network to a data table.
- predictiveapriori - class implementing the predictive apriori algorithm to mine association rules.
weka classifier reader - reads a weka classification model from  a (zip) file.
- subset matcher - the node matches all subsets of the first input table with all sets of the second input table.
ordinalclassclassifier - meta classifier that allows standard  classification algorithms to be applied to ordinal class problems.
simplekmeans - cluster data using the k means algorithm.
- file upload - quick form node that allows uploading a file and exposing that uploaded file using a flow variable.
ng visual clusterer (beta) -
network feature extractor - creates for each network a feature  vector.
- variables - java edit variable - edit a flow variable using java code.
universe marker (apply) - applies universe definition as given  from universe marker node.
- partition graph creator - creates a partition graph from the input graph.
- dict replacer - replaces whole terms that match with dictionary keys with corresponding specified values.
object inserter - inserts nodes and edges from a data table into  the network.
predictiveapriori - class implementing the predictive apriori  algorithm to mine association rules.
a meta classifier for handling multi-class datasets with  2-class classifiers by building an ensemble of nested dichotomies.
- image column writer - writes all in a column images to a directory.
- concatenate - concatenates two tables row-wise.
- naive bayes predictor - uses the naive bayes model from the naive bayes learner to predict the class membership of each row in the input data.
- naivebayessimple - class for building and using a simple naive bayes classifier.
hyphenator - hyphenates terms.
nnge - nearest-neighbor-like algorithm using non-nested  generalized exemplars (which are hyperrectangles that can be viewed as if-then  rules).
- pos tagger - assigns part of speech tags to terms.
- simplecart - class implementing minimal cost-complexity pruning.
zernike converter - transforms complex numbers into normal  double values using the magnitude.
- densitybasedcluster - class for wrapping a clusterer to make it return a distribution and density.
data to report - provides the incoming data to the knime report  designer.
- stanford tagger - assigns part of speech tags to terms.
implements base routines for generating m5 model  trees and rules.
moving average - adds a column with moving average values.
- randomtree - class for constructing a tree that considers k randomly chosen attributes at each node.
- farthestfirst - cluster data using the farthestfirst algorithm.
- term grouper - groups terms by their text.
- smote - adds artificial data to improve the learning quality using the smote algorithm - set operator - performs a set operation on two selected table columns.
naivebayessimple - class for building and using a simple naive  bayes classifier.
frequencies frequency filter - filters terms with a certain frequency value.
this method constructs a decision tree based classifier that maintains highest accuracy on training data and improves on generalization accuracy as it grows in complexity.
- groupby - groups the table by the selected column(s) and aggregates the remaining columns using the selected aggregation method.
- test data generator - creates a data table with all common data types.
- rbfnetwork - class that implements a normalized gaussian radial basisbasis function network.
suitable  for german and english texts.
r local r learner (local) - allows execution of r commands in a local r  installation and build a r model.
- pmml to cell - converts the pmml port to a table containing the pmml cell.
multilayerperceptron - a classifier that uses backpropagation to  classify instances.
copyright © 2012 knime.com ag
- texture node - calculates the texture features of an image.
quick form date (string) input - outputs a date in a string flow variable  with a given value.
- spark line appender - appends a column holding spark line plots based on the selected columns.
plsclassifier - a wrapper classifier for the plsfilter,  utilizing the plsfilter's ability to perform predictions.
- reference row filter - the reference row filter allows rows to be filtered from the first table using the second table as reference.
- filter - column filter - the column filter allows columns to be excluded from the input table.
- nd - a meta classifier for handling multi-class datasets with 2-class classifiers by building a random tree structure.
- lbr - lazy bayesian rules classifier.
- extract color - extract color information (rgb) from a color model.
- hilite collector - node allows to apply annotations to sets of hilit rows within a view.
gridsearch - performs a grid search of parameter pairs for the a  classifier (y-axis, default is linearregression with the "ridge"  parameter) and the plsfilter (x-axis, "# of components") and chooses  the best pair found for the actual predicting.
dict replacer - replaces whole terms that match with dictionary  keys with corresponding specified values.
count execution programmatically - counts the number of  executions.
- create table structure - creates an empty table (no rows) with a predefined structure (columns).
- feature selection - backward feature elimination start (1:1) -
- case converter - converts terms to lower or upper case.
- conditional box plot - a box plot displays robust statistical parameters for numerical attributes and identifies extreme outliers.
- weka classifier writer - writes a weka classification model to a (zip) file.
- inject variables (data) - merges variables from one connection into the data connection.
- pnn - pnn learner (dda) - trains a probabilistic neural network (pnn) on labeled data.
the implementation of a ripple-down rule learner.
xmeans - cluster data using the x-means algorithm.
gamma distributed assigner - assigns a value based on the class  column.
nd - a meta classifier for handling multi-class datasets with  2-class classifiers by building a random tree structure.
- country extractor - extracts the corresponding country for a given ip address.
parallel execution parallel chunk end - represents the end of a parallel chunked  flow.
difference checker - compares the two input tables.
- stackingc - implements stackingc (more efficient version of stacking).
numerical beta distributed assigner - assigns a value based on the class  column.
feature value filter - this filter either bypasses or filters  the network elements (nodes/edges) that match the given filter value.
transformation bow creator - bag of words creator.
- filteredclassifier - class for running an arbitrary classifier on data that has been passed through an arbitrary filter.
ng construct&view - generator and viewer for neighborgrams ng construct (beta) - generator for neighborgram data structure;  suitable for further processing with ng visual clustering node.
- normalizer - normalizes the attributes of a table.
votedperceptron - implementation of the voted perceptron  algorithm by freund and schapire.
network beef reader - parses a specified beef file and creates a node,  edge and feature table.
v5.0 hyperpipes - class implementing a hyperpipe classifier.
- concatenate (optional in) - concatenates tables row-wise, inputs are optional.
leastmedsq - implements a least median sqaured linear regression  utilising the existing weka linearregression class to form predictions.
- edge weight filter - filters all edges by their weight.
- gridsearch - performs a grid search of parameter pairs for the a classifier (y-axis, default is linearregression with the "ridge" parameter) and the plsfilter (x-axis, "# of components") and chooses the best pair found for the actual predicting.
oner - class for building and using a 1r classifier; in other  words, uses the minimum-error attribute for prediction, discretizing numeric  attributes.
test data generator - creates a data table with all common data  types.
- ng construct&view - generator and viewer for neighborgrams - ng construct (beta) - generator for neighborgram data structure; suitable for further processing with ng visual clustering node.
misc ij macro - executes an imagej macro modular data generation conditional label assigner - assigns the classes based on the  probabilities to the rows.
- xslt - applies xslt stylesheets on the cells of an xml column.
simplelogistic - classifier for building linear logistic  regression models.
- reptree - fast decision tree learner.
regressionbydiscretization - a regression scheme that employs  any classifier on a copy of the data that has the class attribute (equal-width)  discretized.
- molconverter - molconverter converts between various data types.
rbfnetwork - class that implements a normalized gaussian radial  basisbasis function network.
- remote - r snippet (remote) - allows execution of r commands on an r server.
external tool (labs) - process the input data using an external  application.
- text processing - io - dml document parser - parses dml formatted documents.
- document data extractor - extracts data from a document into data columns - document vector - creates a document vector for each document.
- isotonicregression - learns an isotonic regression model.
- filteredassociator - class for running an arbitrary associator on data that has been passed through an arbitrary filter.
vote - class for combining classifiers.
- model to cell - converts a model input into a single table cell.
- kstar - k* is an instance-based classifier, that is the class of a test instance is based upon the class of those training instances similar to it, as determined by some similarity function.
network creator - creates a new empty network.
- bitvector generator - generates bitvectors either from a table containing numerical values, or from a string column containing the bit positions to set, hexadecimal or binary strings.
- preset date/time - presets date or time to timestamps lacking this information.
- shuffle - shuffles the rows of the input tables.
- one rule inserter - inserts one specific rule to the given data set.
- column list loop start - iterates over a list of columns - generic loop start - generic loop start node with no termination criterion.
file difference checker - compares the two files.
- simplelogistic - classifier for building linear logistic regression models.
- generic webservice client - accesses document-style webservices - math formula - evaluates mathematical formula, appending result as a new column or replacing an input column.
- caim applier - takes a binning (discretization) model and a data table as input and bins (discretizes) the columns of the input data according to the model.
- pca - pca - principal component analysis - pca compute - principal component analysis computation - pca apply - apply principal components projection - pca inversion - inverse the pca transformation - svm - libsvm - libsvmlearner - libsvm is an integrated software for support vector classification.
- shape appender - appends shapes to one selected column.
pos tagger - assigns part of speech tags to terms.
- row to network - converts the network cells of a data table into a single network.
- vfi - classification by voting feature intervals.
cluster algorithms dbscan - martin ester, hans-peter kriegel, joerg sander, xiaowei  xu:
filter edge degree filter - filters all edges by their number of nodes.
- image to report - provides the incoming image to the knime report designer.
xml writer - writes xml documents in a directory.
the data is simply handed through.
- visualization - network viewer - visualizes a network.
- rule viewer - this node visualizes a set of rules that are represented as a table containing numeric support, confidence, lift values and nominal values for the consequence and antecedence.
- database - database reader - establishes and opens a database access connection to read a table from.
- time series - date field extractor - extracts date fields from a date/time and appends the values as integer columns.
- r model writer - writes an r model to a (zip) file.
functions gaussianprocesses - implements gaussian processes for regression  without hyperparameter-tuning.
- radar plot appender - creates radar plots for each row, summarizing selected doubles in this row - statistics - regression - linear regression (learner) -
misc flr - fuzzy lattice reasoning classifier (flr)
prism - class for building and using a prism rule set for  classification.
preprocessing lowpass filter - does a lowpass filtering on the images in the  selected column.
- j48 - class for generating an alternating decision tree.
decisiontable - class for building and using a simple decision  table majority classifier.
- string to xml - converts string cells in a column to xml.
- decorate - decorate is a meta-learner for building diverse ensembles of classifiers by using specially constructed artificial training examples.
winnow - implements winnow and balanced winnow algorithms by  littlestone.
- time generator - generates time values - time to string - converts a timestamp column into a column holding strings.
- misc classifiers - k nearest neighbor - classifies a set of test data based on the k nearest neighbor algorithm using the training data.
number filter - filters term consisting of numbers.
- assign partition - assigns objects to the given partition of the given type.
- preprocessing - abner filter - filters terms with certain biomedical named entity tags.
- item set finder - provides different algorithms to searches for frequent items in a list of item sets.
- cvparameterselection - class for performing parameter selection by cross-validation for any classifier.
- cell splitter by position - splits cells in one column of the table at fixed positions into separate columns.
- fingerprint bayesian (predictor) - predictor to the fingerprint bayesian (learner) node, assigning score values to test data.
voronoi segmentation - voronoi based segmentation features histogram node - calculates the histogram features of an image.
multiclassclassifier - a metaclassifier for handling multi-class  datasets with 2-class classifiers.
- preprocessing - lowpass filter - does a lowpass filtering on the images in the selected column.
- io - weka serializedclassifier write - takes a trained weka model and writes the weka classifier to a file.
- histogram chart (jfreechart) - display a histogram chart.
this value is gaussian distributed as defined in the configuration by its mean and standard deviation.
dagging - this meta classifier creates a number of disjoint,  stratified folds out of the data and feeds each chunk of data to a copy of the  supplied base classifier.
- logistic - class for building and using a multinomial logistic regression model with a ridge estimator.
time series date field extractor - extracts date fields from a date/time and  appends the values as integer columns.
- split & combine - cell splitter - splits cells in one column of the table into separate columns based on a specified delimiter.
double input - outputs a double-precision floating point  variable with a given value.
- nnge - nearest-neighbor-like algorithm using non-nested generalized exemplars (which are hyperrectangles that can be viewed as if-then rules).
io r model reader - reads an r model from a file.
- classificationviaregression - class for doing classification using regression methods.
- string replacer - replaces values in string cells if they match a certain wildcard pattern.
- linear correlation - computes correlation coefficients for pairs of numeric or nominal columns.
- string to number - converts strings in a column to numbers.
this node uses a svm model generated by the svm learner node to predict the output for given parameters.
- case switch - outputs the input table to exactly one of the output ports.
- hierarchical clustering (distmatrix) - performs hierarchical clustering on distance matrix input.
viz input connector - read networks from external program.
adaboostm1 - class for boosting a nominal class classifier using  the adaboost m1 method.
- sdml document parser - parses sdml formatted documents.
reporting table writer table to html - generates html reports out of input data by  using the birt reporting engine.
weka clustering writer - writes a weka clustering model to a  (zip) file.
file download - provides a knime quick form with a downloadable  file.
- crosstab - creates a cross-tabulation (also referred as contingency table or cross-tab).
country extractor - extracts the corresponding country for a  given ip address.
- pie chart - displays data in a pie chart.
the list of files needs to be defined by the input table, whereby each row represents one individual file location.
- network - io - file - beef reader - parses a specified beef file
- random matcher - assigns the information from the second table randomly to the rows of the first table - stresser - adds stress (outliers) to the values.
oscar tagger - assigns chemical named entity tags to terms.
- table reader - reads table written by the table writer node.
- extract time window - extracts all rows within the specified time window.
- gamma distributed assigner - assigns a value based on the class column.
stanford tagger - assigns part of speech tags to terms.
- flat file document parser - parses flat text files.
matrix to network - creates a network from the matrix.
- domain calculator - determines domain information of selected columns.
- rule induction - fuzzy rules - fuzzy rule learner - learns a fuzzy rule model on labeled numeric data.
userclassifier - interactively classify through visual means.
the end loop node for the timedelayloopstart collects the input line and transfers it to the start node - timedelay loop start - this looping double creates new rows, based on the values of input.
- loop x-times - executes the contained workflow multiple times.
performs a multivariate linear regression.
- association rules - apriori - class implementing an apriori-type algorithm.
- line reader - read lines from a file or url.
- filter - edge degree filter - filters all edges by their number of nodes.
filteredclassifier - class for running an arbitrary classifier  on data that has been passed through an arbitrary filter.
- network generator - generates nodes and edges depending on the selected algorithms and inserts them into the given network.
tags to string - converts tags to strings.
kuhlen stemmer - stems terms with the kuhle stemming algorithm.
- renderer to svg - creates svg cells using a renderer - box plot - a box plot displays robust statistical parameters for numerical attributes and identifies extreme outliers.
- xml - xml reader - reads a xml file.
interactive clusterer for neighborgrams, which were constructed with the ng construct node.
stts filter - filters terms with certain stts tags.
- naivebayesmultinomialupdateable - class for building and using a multinomial naive bayes classifier.
- voting loop end - determines the most frequent value from a collection of prediction columns.
- knime labs - image processing - io - picture chooser - reads images from a directory.
- model content difference checker - compares the two input models.
weka predictor - the weka predictor takes a model generated in a  weka node and classifies the test data at the inport.
- sentence extractor - extracts all sentences of a document as string.
em - simple em (expectation maximisation) class.
farthestfirst - cluster data using the farthestfirst algorithm.
- tags to string - converts tags to strings.
extract time window - extracts all rows within the specified  time window.
string to xml - converts string cells in a column to xml.
document viewer - displays all data of the given documents, like  text, authors, publication date and so on.
- unpivoting - this node rotates the selected columns from the input table to rows and duplicates at the same time the remaining input columns by appending them to each corresponding output row.
decorate - decorate is a meta-learner for building diverse  ensembles of classifiers by using specially constructed artificial training  examples.
- integer input - outputs an integer flow variable with a given value.
weka serializedclassifier read - a wrapper around a serialized  classifier model.
- parallel coordinates - plots the data in parallel coordinates.
opennlp ne tagger - assigs named entity tags, such as  "person" or "location".
network generator - generates nodes and edges depending on the  selected algorithms and inserts them into the given network.
- extract column header - creates new table with a single row containing the column names.
- file download - provides a knime quick form with a downloadable file.
- transformation - bow creator - bag of words creator.
- correlation filter - filters out correlated columns.
- normalizer (apply) -
- xmeans - cluster data using the x-means algorithm.
- delegating loop start - this is the loop start for performing delegating, a version of meta learning.
- cluster algorithms - dbscan - martin ester, hans-peter kriegel, joerg sander, xiaowei xu:
line node - calculates the line features of an image.
this class is an implementation of the minimal  and maximal extension.
- split collection column - splits a collection column into its sub components, adding one new column for each.
- smo - implements john platt's sequential minimal optimization algorithm for training a support vector classifier.
sdml document parser - parses sdml formatted documents.
- scatter matrix - plots a scatter matrix where each column is compared to all others.
- neighborgrams - universe marker - defines universes (i.e. descriptors) for processing in neighborgrams or fuzzy cu means.
tertius - finds rules according to confirmation measure  (tertius-type algorithm).
- number filter - filters term consisting of numbers.
- parallel chunk start - represents the start of a parallel chunked flow.
- read png images - read png images from a list of urls and append them as a new column.
- string to date/time - parses date and/or time strings into date/time cells.
- nominal value row filter - filters rows on nominal attribute value - numeric row splitter - node splits the input data according to a given numeric range.
- column to xml - create an xml column from input data.
- model writer - writes knime model port objects to a file.
image to report - provides the incoming image to the knime  report designer.
bftree - class for building a best-first decision tree  classifier.
filteredcluster - class for running an arbitrary clusterer on  data that has been passed through an arbitrary filter.
- weka clustering writer - writes a weka clustering model to a (zip) file.
- decision tree to image - renders a decision tree view on an image (png).
- database connection reader - reads the entire data from the input database connection.
partition graph creator - creates a partition graph from the  input graph.
- database looping - this node runs sql queries in the connected database restricted by the possible values given by the input table.
- linearregression - class for using linear regression for prediction.
- grading - implements grading.
- r predictor (local) - allows to import a r model and predict given data by the use of the model.
- xml column combiner - merges xml columns in a single column.
io weka serializedclassifier write - takes a trained weka model and  writes the weka classifier to a file.
filteredassociator - class for running an arbitrary associator  on data that has been passed through an arbitrary filter.
- hyphenator - hyphenates terms.
- line chart (jfreechart) - display a line plot using x,y data points and connects them using a line.
- mds projection - multi dimensional scaling node, mapping data of a high dimensional space onto a lower dimensional space by applying a modified sammons mapping with respect to a given set of fixed points.
- roc curve - shows roc curves - scorer - compares two columns by their attribute value pairs.
- convert - matrix - edge adjacency matrix - creates the edge adjacency matrix.
- perl scripting - runs a perl script which creates a new column or replaces an existing one.
- neural network - mlp - multilayerperceptron predictor - predicts output values based on a trained mlp.
- image port writer - writes a image port object to a file.
- one row to many - creates duplicates of the rows, based on an integer column.
- number to string - converts numbers in a column to strings.
this class is an implementation of the minimal and maximal extension.
- decisionstump - class for building and using a decision stump.
- thresholdselector - a metaclassifier that selecting a mid-point threshold on the probability output by a classifier.
paceregression - class for building pace regression linear  models and using them for prediction.
naivebayesmultinomialupdateable - class for building and using a  multinomial naive bayes classifier.
network to row - converts the given network into a data row.
start node for a backward feature elimination loop - backward feature elimination start (2:2) -
- random label assigner - assigns the labels based on the probabilities to the rows.
naivebayesmultinomial - class for building and using a  multinomial naive bayes classifier.
random item inserter - assigns the labels based on the  probabilities to the rows.
- gaussian distributed assigner - assigns a value based on the class column.
- marvinview - marvinview is a chemical structures visualization tool.
xml combine and write - writes xml cells in a file.
this node creates a bubble-chart visualization.
- costsensitiveclassifier -
the conditional box plot partitions the data of one column into classes and creates a box plot for each of them.
thresholdselector - a metaclassifier that selecting a mid-point  threshold on the probability output by a classifier.
- row filter - allows filtering of datarows by certain criteria, such as row id, attribute value, and row number range.
- node adjacency matrix - creates the node adjacency matrix.
string to term - converts strings to terms.
term grouper - groups terms by their text.
- partitioning - splits table into two partitions.
- idf - computes the inverse document frequency (idf) of each term according to the given set of documents and adds a column containing the idf value.
- extract system properties - reads system properties, including current user name and working directory.
- time difference - appends the difference between two dates.
laplacian matrix - creates the laplacian matrix.
- oner - class for building and using a 1r classifier; in other words, uses the minimum-error attribute for prediction, discretizing numeric attributes.
- pie chart (interactive) - displays data in an interactive pie chart with hiliting support.
row to network - converts the network cells of a data table into  a single network.
snowball stemmer - stems terms with the snowball stemmer.
- laplacian matrix - creates the laplacian matrix.
a meta classifier for handling multi-class datasets with 2-class classifiers by building an ensemble of nested dichotomies.
- network creator - creates a new empty network.
- table - edge table - writes the id and label of all edges and their incident nodes of the incoming network to a data table.
can be used to convert a directed into an undirected network by filtering the is_target feature.
the end loop node for the  timedelayloopstart collects the input line and transfers it to the start node timedelay loop start - this looping double creates new rows,  based on the values of input.
aggregation method and termination criteration must be set using the loop start and end node contained in the workflow.
hnb - contructs hidden naive bayes classification model with  high classification accuracy and auc.
- column merger - merges two columns into one by choosing the cell that is non-missing.
using separate-and-conquer.
- distance matrix writer - writes column containing distance matrix to file.
- quick form - date (string) input - outputs a date in a string flow variable with a given value.
randomcommittee - class for building an ensemble of randomizable  base classifiers.
- table writer - writes a data table to a file using an internal format.
- python - jpython function - executes a jpython function - jpython script 1:1 - executes a jpython script, taking 1 input table and returning 1 output table.
this class is an implementation of the ordinal learning method.
weka clustering reader - reads a weka clustering model from a  (zip) file.
- feature inserter - inserts features from a data table into the network.
this class implements a single conjunctive rule learner that can predict for numeric and nominal class labels.
- xpath - performs a xpath query on a xml column.
ibk - k-nearest neighbours classifier.
time difference - appends the difference between two dates.
- matrix to network - creates a network from the matrix.
- node neighbor extractor - extracts all neighbors of the given node ids.
this class is an implementation of the ordinal stochastic dominance learner.
- convert & replace - category to number - maps each category of a column with nominal data to an integer.
- association rule learner - provides different algorithms to searches for frequent items in a list of item sets.
- misc - empty table creator - creates an empty table: simply lines and rowkeys (no columns).
- dagging - this meta classifier creates a number of disjoint, stratified folds out of the data and feeds each chunk of data to a copy of the supplied base classifier.
- decisiontable - class for building and using a simple decision table majority classifier.
- leastmedsq - implements a least median sqaured linear regression utilising the existing weka linearregression class to form predictions.
- svmreg - svmreg implements the support vector machine for regression.
- size appender - appends sizes to one selected column.
- feature filter - hides features from the input network.
- reference column filter - the reference column filter allows columns to be filtered from the first table using the second table as reference.
this class is an implementation of the ordinal stochastic  dominance learner.
- svm learner - trains a support vector machine.
- network to row - converts the given network into a data row.
strings to document - converts the specified strings to  documents.
- misc - category to class - adds a class (string) column to each row, containing the category string of the document in that particular row.
- stts filter - filters terms with certain stts tags.
- ng learner (beta) - learns a classification model based on neighborgrams.
r view (local) - enables the usage of r views using the local r  installation.
- random number assigner - assigns a value based on the class column.
- logistic regression (learner) - performs a multinomial logistic regression.
n chars filter - filters terms consisting of less than n  characters.
- ordinalclassclassifier - meta classifier that allows standard classification algorithms to be applied to ordinal class problems.
- neighbor filter - filters all objects pairs from the input table that are not adjacent/incident in the network.
enrichment abner tagger - assigns biomedical named entity tags to terms.
- randomforest - class for constructing a forest of random trees.
string radio buttons - outputs a string flow variable with a  given value.
one rule inserter - inserts one specific rule to the given data  set.
- shape manager - assigns shapes to one selected nominal column.
kstar - k* is an instance-based classifier, that is the class of  a test instance is based upon the class of those training instances similar to  it, as determined by some similarity function.
- data views - property - color manager - assigns colors to a selected nominal or numeric column.
- tf - computes the relative term frequency (tf) of each term according to each document and adds a column containing the tf value.
- racedincrementallogitboost - classifier for incremental learning of large datasets by way of racing logit-boosted committees.
- external ssh tool - executes an external tool on a remote machine via ssh.
interactive clusterer for  neighborgrams, which were constructed with the ng construct node.
- string replace (dictionary) - replaces the values in a column by matching entries of a dictionary file.
texture node - calculates the texture features of an image.
- variable output - provides the value of a selected variable to a remote quick form.
- misc - ij macro - executes an imagej macro - modular data generation - categorical - conditional label assigner - assigns the classes based on the probabilities to the rows.
- column comparator - compares the cell values of two columns row-wise using different comparison methods.
multiboostab - class for boosting a classifier using the  multiboosting method.
mask date/time - masks (removes) date or time fields from  existing date/time.
- weka clustering reader - reads a weka clustering model from a (zip) file.
- arff reader - reads arff data files.
- paceregression - class for building pace regression linear models and using them for prediction.
- vote - class for combining classifiers.
- xls writer - saves a datatable into a spreadsheet.
preprocessing abner filter - filters terms with certain biomedical named  entity tags.
- node table - writes all nodes of the incoming network to a data table.
- transform - bitvector generator - generates bitvectors either from a table containing numerical values, or from a string column containing the bit positions to set, hexadecimal or binary strings.
modifiable term filter - filters terms which are set modifiable  or unmodifiable, respectively.
- auto-binner (apply) -
- k-medoids - performs k-medoids algorithm.
the base classifiers are  "graded".
- trees - adtree - class for generating an alternating decision tree.
time field extractor - extracts time fields such as and appends  the value as integer columns.
- term to string - converts terms to strings and adds a new column containing these strings.
- ungroup - creates for each list of collection values a list of rows with the values of the collection in one column and all other columns given from the original row.
- sota predictor - predicts classes for rows using the input sota model.
if switch - allows to manually control which branch the data will flow into.
vfi - classification by voting feature intervals.
- double input - outputs a double-precision floating point variable with a given value.
the result of these r commands is returned in the output table of this node.
- pos filter - filters terms with certain pos tags.
- frequencies - frequency filter - filters terms with a certain frequency value.
node degree filter - filters all nodes by their degree e.g.  number of incoming/outgoing edges.